1111111111111111111111111111111111
101000C00000000C00000C0000010C0001
1000100100100000101001000000010101
1C10010010001010001001000000010101
1P000000C00C0000000000C00000000C11
1010010010000101000100100000001011
1010010010000101000100100000001011
1010010010000101000100100000001011
1010010010000101000100100000001011
1010010010000101000100100000001011
1010010010000101000100100000001011
1010010010000101000100100000001011
1010010010000101000100100000001011
1010010010000101000100100001001011
1010000C00C0000000000000000E1C0111
1111111111111111111111111111111111
1111111111111111111111111111111111