1111111111111111111111111111
1P00000000000110000000000001
1011110111110110111110111101
1010010100N101101N0010100101
1011110111110110111110111101
1C000000000000000000000000C1
1011110110111111110110111101
1011110110111001110110111101
1000000110000110000110000001
1111110111110110111110111111
1011010111110110111110101101
11N011011000000000011011N011
1011010110111001110110101101
1111110110100000010110111111
110000000010000E010000000011
11111100101000C0010100111111
11010101N0100000010010110101
1010110C10111111110100101011
11010101C0000C00000C10110101
1010110N101111111101N0101011
1111110100100110010010111111
1000000000000110000000000001
1011110111010110101110111101
1010110111110110111110110101
1000110000000000000000110001
1111111111111111111111111111
