11111111111111111111111111111111111111111
1NCN11NC00000000000001100000101100000CN11
10000000011111NC1111000010010000000110001
1001111001N1N1NC1NC1101001000110000011001
1CN1EC1NC1C1C1111NCN1C010011100010011NC01
1111N011110000000000111000001100001001001
1NC0000000CNC0111NC0P0C0N110CNC10CNC00CN1
11111111111111111111111111111111111111111
11111111111111111111111111111111111111111
11111111111111111111111111111111111111111
11111111111111111111111111111111111111111
11111111111111111111111111111111111111111
11111111111111111111111111111111111111111