111111111111111111111111111
1P0000100CC0000000000000001
101110101111111100001101001
101000101000000111111NC1101
100011101111110000001N01001
111010100000000001001111001
100010100000111011100001001
1011100000001ECCCN100011001
100010111000111111101011101
11101000100C000100001000101
100010001000000101111011101
10000000100C00010000C000001
10000010111011111110000N001
100NNN100000000000000000001
111111111111111111111111111