111111111111111111111111111
1P0000100000CCCC00000000001
101110101111111100001101001
101000101000000111111CC1101
100011101111110000001CC1001
1110101CCCC0000001001111001
100010100000111011100001001
1011100000001ECCCC100011001
100010111000111111101011101
11101000100C000100001000101
100010001000000101111011101
10000000100C00010000C000001
100000101110111111100000001
1CCCCC1CCCCCCCCCCCCCCCCCCC1
111111111111111111111111111